"filename", "language", "CSS", "TypeScript", "XML", "TypeScript JSX", "comment", "blank", "total"
"/Users/meherwangill/programming/anarchy-chess/AnarchyChess/AnarchChessVite/src/App.css", "CSS", 37, 0, 0, 0, 0, 6, 43
"/Users/meherwangill/programming/anarchy-chess/AnarchyChess/AnarchChessVite/src/App.tsx", "TypeScript JSX", 0, 0, 0, 12, 5, 3, 20
"/Users/meherwangill/programming/anarchy-chess/AnarchyChess/AnarchChessVite/src/assets/react.svg", "XML", 0, 0, 1, 0, 0, 0, 1
"/Users/meherwangill/programming/anarchy-chess/AnarchyChess/AnarchChessVite/src/components/ChessLogic/ChessLogic.ts", "TypeScript", 0, 539, 0, 0, 117, 99, 755
"/Users/meherwangill/programming/anarchy-chess/AnarchyChess/AnarchChessVite/src/components/ChessLogic/Tests/ChessLogic.test.ts", "TypeScript", 0, 405, 0, 0, 0, 27, 432
"/Users/meherwangill/programming/anarchy-chess/AnarchyChess/AnarchChessVite/src/components/ChessLogic/Tests/checkForCastling.test.ts", "TypeScript", 0, 68, 0, 0, 0, 11, 79
"/Users/meherwangill/programming/anarchy-chess/AnarchyChess/AnarchChessVite/src/components/ChessLogic/Tests/checkForCheck.test.ts", "TypeScript", 0, 169, 0, 0, 0, 27, 196
"/Users/meherwangill/programming/anarchy-chess/AnarchyChess/AnarchChessVite/src/components/ChessLogic/Tests/checkMoveWithActionAndUndo.test.ts", "TypeScript", 0, 143, 0, 0, 0, 23, 166
"/Users/meherwangill/programming/anarchy-chess/AnarchyChess/AnarchChessVite/src/components/ChessLogic/Tests/enPassant.test.ts", "TypeScript", 0, 63, 0, 0, 3, 11, 77
"/Users/meherwangill/programming/anarchy-chess/AnarchyChess/AnarchChessVite/src/components/ChessLogic/Tests/moveGeneratingFunctions.test.ts", "TypeScript", 0, 195, 0, 0, 0, 19, 214
"/Users/meherwangill/programming/anarchy-chess/AnarchyChess/AnarchChessVite/src/components/ChessLogic/Tests/postMoveComputation.test.ts", "TypeScript", 0, 187, 0, 0, 9, 33, 229
"/Users/meherwangill/programming/anarchy-chess/AnarchyChess/AnarchChessVite/src/components/ChessLogic/checkForCheck.ts", "TypeScript", 0, 159, 0, 0, 12, 31, 202
"/Users/meherwangill/programming/anarchy-chess/AnarchyChess/AnarchChessVite/src/components/ChessLogic/moveGeneratingFunctions.ts", "TypeScript", 0, 402, 0, 0, 26, 58, 486
"/Users/meherwangill/programming/anarchy-chess/AnarchyChess/AnarchChessVite/src/components/Chessboard/Chessboard.css", "CSS", 0, 0, 0, 0, 0, 1, 1
"/Users/meherwangill/programming/anarchy-chess/AnarchyChess/AnarchChessVite/src/components/Chessboard/Chessboard.tsx", "TypeScript JSX", 0, 0, 0, 32, 0, 4, 36
"/Users/meherwangill/programming/anarchy-chess/AnarchyChess/AnarchChessVite/src/index.css", "CSS", 3, 0, 0, 0, 0, 0, 3
"/Users/meherwangill/programming/anarchy-chess/AnarchyChess/AnarchChessVite/src/main.tsx", "TypeScript JSX", 0, 0, 0, 9, 0, 2, 11
"/Users/meherwangill/programming/anarchy-chess/AnarchyChess/AnarchChessVite/src/shared/enums.ts", "TypeScript", 0, 43, 0, 0, 4, 6, 53
"/Users/meherwangill/programming/anarchy-chess/AnarchyChess/AnarchChessVite/src/shared/helperFunctionsForTest.ts", "TypeScript", 0, 16, 0, 0, 0, 3, 19
"/Users/meherwangill/programming/anarchy-chess/AnarchyChess/AnarchChessVite/src/shared/types.ts", "TypeScript", 0, 31, 0, 0, 0, 5, 36
"/Users/meherwangill/programming/anarchy-chess/AnarchyChess/AnarchChessVite/src/shared/utility.ts", "TypeScript", 0, 50, 0, 0, 0, 11, 61
"/Users/meherwangill/programming/anarchy-chess/AnarchyChess/AnarchChessVite/src/vite-env.d.ts", "TypeScript", 0, 0, 0, 0, 1, 1, 2
"Total", "-", 40, 2470, 1, 53, 177, 381, 3122